In the beginning there is infinite possibility. We all begin in darkness; without light there is no time, only waiting.

In this game, you type words using your keyboard. If you'd like a hint, type hint and press enter. For a list of commands, type commands.

Passenger
An Interactive Fiction by Erin Hoffman-John
Release 1 / Serial number 160423 / Inform 7 build 6M62 (I6/v6.33 lib 6/12N) SD

Emptiness
A vast darkness extends in all directions. Distantly, blurry motes of light seem to float on the horizon -- or it might be a trick of your eyes. 

 There are no obvious exits.

You can see a glowing portal here.

>beckon
What do you want to beckon?

>beckon light
You gesture invitingly toward the light. It pauses in midair, then, very distinctly, it draws closer.

>beckon light
You beckon the light closer again. Again it grows still, seeming to watch you. In its stillness it seems suddenly alive.

After a long moment, the light again swings closer to you.

>beckon light
The light seems less hesitant now, and it's grown larger. Now when you beckon it seems to have been waiting for your gesture, and it immediately floats closer to your hand, near enough to touch.

>take light
The lights are small and elusive.

>touch light
You stretch out your hand and brush the light with your fingertips.

The light shimmers close, weaves one little loop around you, then gathers at your feet. It pools upward, forming a cup, and finally a vessel.

>take vessel
The darkness darkens, and when it brightens again, you are somewhere else.

A Grassy Island, North End
The north end of the island descends into starlight. From the knee-high grasses here one can look out at the infinite stars.

>south
A Grassy Island, Center
The island rises to its zenith here in the center, marked by a tiny stand of redwood trees.

>look at nest
You can't see any such thing.

>look at trees
A sudden narrow stand of redwoods erupts out of the ground at the center of the island. On one low slung branch of the nearest tree, you can see a nest made of twigs.

>look at nest
This nest was well maintained at one time, but its occupants have migrated elsewhere.

In the nest is a feather.

>take feather
Taken.

* * *

>beckon light
You gesture invitingly toward the light. It pauses in midair, then, very distinctly, it draws closer.

* * *

>beckon light
You beckon the light closer again. Again it grows still, seeming to watch you. In its stillness it seems suddenly alive.

After a long moment, the light again swings closer to you.

I beg your pardon?

>touch light
The light is almost close enough to touch, but when you stretch out your arm, it dances away from your fingertips.

The gentle light is quite close. You could almost reach out and touch it, but not quite.

>beckon light
The light seems less hesitant now, and it's grown larger. Now when you beckon it seems to have been waiting for your gesture, and it immediately floats closer to your hand, near enough to touch.

>touch light
You stretch out your hand and brush the light with your fingertips.

The light shimmers close, weaves one little loop around you, then gathers at your feet. It pools upward, forming a cup, and finally a vessel.

>touch vessel
The darkness darkens, and when it brightens again, you are somewhere else.

A Grassy Island, North End
The north end of the island descends into starlight. From the knee-high grasses here one can look out at the infinite stars.

A path south leads to the center of the island.

You can see a shadowy vessel and an alabaster monument here.

>south
A Grassy Island, Center
The island rises to its zenith here in the center, marked by a tiny stand of redwood trees. 

Worn paths lead north (back to the portal), south, east, and west from here.

>south
A Grassy Island, South End
A mirror for the north end of the island, the south end too rolls downward and gradually vanishes into darkness. The grasses here rise and fall in gentle hummocks. 

A path leads north back to the center of the island from here.

>look hummock
As you part the fragrant grasses of one of the hummocks, you discover a tunnel leading down into a cave.

>look
A Grassy Island, South End
A mirror for the north end of the island, the south end too rolls downward and gradually vanishes into darkness. The grasses here rise and fall in gentle hummocks. 

A path leads north back to the center of the island from here. 

A narrow trace leads down into a subterranean cave, while another path leads north, back to the center of the island.

You can see a cave here.

* * *

>touch light
You stretch out your hand and brush the light with your fingertips.

The light shimmers close, weaves one little loop around you, then gathers at your feet. It pools upward, forming a cup, and finally a vessel.

>look
Emptiness
A vast darkness extends in all directions. Distantly, blurry motes of light seem to float on the horizon -- or it might be a trick of your eyes. 

A glowing portal leads to another world.

You can see a vessel (empty) here.

>touch vessel
The darkness darkens, and when it brightens again, you are somewhere else.

A Grassy Island, North End
The north end of the island descends into starlight. From the knee-high grasses here one can look out at the infinite stars.

A path south leads to the center of the island.

You can see a shadowy vessel and an alabaster monument here.

* * *

>look hummock
As you part the fragrant grasses of one of the hummocks, you discover a tunnel leading down into a cave.

>look
A Grassy Island, South End
A mirror for the north end of the island, the south end too rolls downward and gradually vanishes into darkness. The grasses here rise and fall in gentle hummocks. 

A narrow trace leads down into a subterranean cave, while another path leads north, back to the center of the island.

You can see a cave here.

>down
A Grassy Island, Subterranean Cave
Light filters down from the grass-fringed opening of the tunnel. Soil and packed dirt give way to rock as the cave winds to the north. 

A path leads north, deeper into the cave, from here, or you can go up exit the cave.

* * *

>touch vessel
The darkness darkens, and when it brightens again, you are somewhere else.

A Grassy Island, North End
The north end of the island descends into starlight. From the knee-high grasses here one can look out at the infinite stars.

A path south leads to the center of the island.

You can see a shadowy vessel and an alabaster monument here.

>east
You can't go that way.

>south
A Grassy Island, Center
The island rises to its zenith here in the center, marked by a tiny stand of redwood trees.

>west
A Grassy Island, West End
The ground rises here into an angled precipice of stacked stone that looks out into the sky. Perched on the edge of the precipice is a brass telescope, trained on a distant blue planet.

You can see a brass telescope (closed) here.

>use telescope
You train the telescope on the blue planet. Far, far below, you see a family eating dinner.

* * *

>look hummock
As you part the fragrant grasses of one of the hummocks, you discover a tunnel leading down into a cave.

>look
A Grassy Island, South End
A mirror for the north end of the island, the south end too rolls downward and gradually vanishes into darkness. The grasses here rise and fall in gentle hummocks. A tunnel leads downward into a subterranean cave.

You can see a cave here.

* * *

>south
A Grassy Island, Center
The island rises to its zenith here in the center, marked by a tiny stand of redwood trees. 

Worn paths lead north (back to the portal), south, east, and west from here.

>west
A Grassy Island, West End
The ground rises here into an angled precipice of stacked stone that looks out into the sky. Perched on the edge of the precipice is a brass telescope, trained on a distant blue planet.

You can see a brass telescope (in which is a glass lens) here.

* * *

>beckon light
You beckon the light closer again. Again it grows still, seeming to watch you. In its stillness it seems suddenly alive.

After a long moment, the light again swings closer to you.

>touch light
The light is almost close enough to touch, but when you stretch out your arm, it dances away from your fingertips.

The gentle light is quite close. You could almost reach out and touch it, but not quite.

* * *

>touch light
You stretch out your hand and brush the light with your fingertips.

The light shimmers close, weaves one little loop around you, then gathers at your feet. It pools upward, forming a cup, and finally a vessel.

>touch vessel
The darkness darkens, and when it brightens again, you are somewhere else.

A Grassy Island, North End
The north end of the island descends into starlight. From the knee-high grasses here one can look out at the infinite stars. 

The only obvious exit is south.

You can see a shadowy vessel and an alabaster monument here.

>south
A Grassy Island, Center
The island rises to its zenith here in the center, marked by a tiny stand of redwood trees. 

The obvious exits are north (to a grassy island, north end), south, east and west.

>east
A Grassy Island, East End
Sheltered from the star winds, this end of the island has a twilight tranquility. A gazebo looks out into the stars, surrounded by carefully manicured grass. 

The only obvious exit is west (to a grassy island, center).

You can see a pedestal (on which is a cloisonne pot (in which is a bonsai plant)) here.

>west
A Grassy Island, Center
The island rises to its zenith here in the center, marked by a tiny stand of redwood trees. 

The obvious exits are north (to a grassy island, north end), south, east (to a grassy island, east end) and west.

>south
A Grassy Island, South End
A mirror for the north end of the island, the south end too rolls downward and gradually vanishes into darkness. The grasses here rise and fall in gentle hummocks. 

The obvious exits are north (to a grassy island, center) and down.

>down
You can't go that way.

>look hummock
As you part the fragrant grasses of one of the hummocks, you discover a tunnel leading down into a cave.

* * *

>look
A Grassy Island, South End
A mirror for the north end of the island, the south end too rolls downward and gradually vanishes into darkness. The grasses here rise and fall in gentle hummocks. A tunnel leads downward into a subterranean cave.

You can see a cave here.

>look
A Grassy Island, South End
A mirror for the north end of the island, the south end too rolls downward and gradually vanishes into darkness. The grasses here rise and fall in gentle hummocks. A tunnel leads downward into a subterranean cave.

You can see a cave here.

>look at cae
You can't see any such thing.

>look at cave
A gap between the grass hummocks reveals a tunnel that leads down into the underground.

(You might get a hint here.).

>down
A Grassy Island, Subterranean Cave
Light filters down from the grass-fringed opening of the tunnel. Soil and packed dirt give way to rock as the cave winds to the north. 

The obvious exits are north and up (to a grassy island, south end).

>north
A Grassy Island, Subterranean Cave
The cave ends here in a rounded wall. A fox has made its nest here. 

The only obvious exit is south (to a grassy island, subterranean cave).

You can see a growling fox here.

* * *

>beckon motes
You gesture invitingly toward the light. It pauses in midair, then, very distinctly, it draws closer.

* * *

>command
There are lots of commands. Some of the important ones for this game are:
inventory - check what you're carrying;
take (thing) - try to pick something up (also "get" or "pick up");
look at (thing) - inspect something - sometimes things are hidden!;
go (place) - move in a direction (north, south, east west), or into something (such as a cave);
hint - get a hint about how to solve one of the puzzles;

>hint
That's not a verb I recognise.

>look at lights
You can't see any such thing.

>look at light
Tiny motes of light float just at the edges of your vision. It's hard to tell if they're there at all.

* * *

>east
glowing portal

>east
A Grassy Island, North End
The north end of the island descends into starlight. From the knee-high grasses here one can look out at the infinite stars.

A path south leads to the center of the island.

You can see a shadowy vessel and an alabaster monument here.

* * *

>look
Emptiness
A vast darkness extends in all directions. Distantly, blurry motes of light seem to float on the horizon -- or it might be a trick of your eyes.

>look motes
You can't see any such thing.

>north
You can't go that way.

>south
You can't go that way.

A gentle light glimmers in the distance. You might beckon it.

>beckon
What do you want to beckon?

* * *

>beckon light
The light seems less hesitant now, and it's grown larger. Now when you beckon it seems to have been waiting for your gesture, and it immediately floats closer to your hand, near enough to touch.

>beckon light
You beckon again, but the light is already as close as it will dare to come. It loops around you again, close enough to touch.

The gentle light swings in little figure eights through the air, passing close enough to touch.

>beckon light
You beckon again, but the light is already as close as it will dare to come. It loops around you again, close enough to touch.

The gentle light swings in little figure eights through the air, passing close enough to touch.

>touch light
You stretch out your hand and brush the light with your fingertips.

The light shimmers close, weaves one little loop around you, then gathers at your feet. It pools upward, forming a cup, and finally a vessel.

>look
Emptiness
A vast darkness extends in all directions. Distantly, blurry motes of light seem to float on the horizon -- or it might be a trick of your eyes.

You can see a vessel (empty) here.

(You might get a hint here.).

>touch vessel
The darkness darkens, and when it brightens again, you are somewhere else.

A Grassy Island, North End
The north end of the island descends into starlight. From the knee-high grasses here one can look out at the infinite stars. 

You can see a shadowy vessel and an alabaster monument here.

>look monument
An alabaster obelisk rising up from the grass, the monument is inscribed with an infinity knot inlaid with shining garnet tiles. Each tile seems to glow from within, reflecting the light of the stars overhead.

As you inspect the monument, one of the tiles falls away from the infinity knot and lands on the ground.

>look tile
This blood red stone tile seems to have stored starlight within it; it glows subtly.

>get tile
Taken.

>look
A Grassy Island, North End
The north end of the island descends into starlight. From the knee-high grasses here one can look out at the infinite stars. 

You can see a shadowy vessel and an alabaster monument here.

>look vessel
You see nothing special about the shadowy vessel.

>look monument
An alabaster obelisk rising up from the grass, the monument is inscribed with an infinity knot inlaid with shining garnet tiles. Each tile seems to glow from within, reflecting the light of the stars overhead.

>look
A Grassy Island, North End
The north end of the island descends into starlight. From the knee-high grasses here one can look out at the infinite stars. 

You can see a shadowy vessel and an alabaster monument here.

>north
You can't go that way.

>south
A Grassy Island, Center
The island rises to its zenith here in the center, marked by a tiny stand of redwood trees. 

(You might get a hint here.).

>south
A Grassy Island, South End
A mirror for the north end of the island, the south end too rolls downward and gradually vanishes into darkness. The grasses here rise and fall in gentle hummocks.

>south
You can't go that way.

>west
You can't go that way.

>east
You can't go that way.

>north
A Grassy Island, Center
The island rises to its zenith here in the center, marked by a tiny stand of redwood trees.

>look trees
A sudden narrow stand of redwoods erupts out of the ground at the center of the island. On one low slung branch of the nearest tree, you can see a nest made of twigs.

>look nest
This nest was well maintained at one time, but its occupants have migrated elsewhere.

In the nest is a feather.

>get feather
Taken.

>look feather
It's a long, slim red feather, grey at the tip. It looks like it came from a sparrow of some kind.

>look
A Grassy Island, Center
The island rises to its zenith here in the center, marked by a tiny stand of redwood trees. 

On the trees is a nest (empty).

>south
A Grassy Island, South End
A mirror for the north end of the island, the south end too rolls downward and gradually vanishes into darkness. The grasses here rise and fall in gentle hummocks.

* * *

>south
You can't go that way.

>look hummocks
You can't see any such thing.

>north
A Grassy Island, Center
The island rises to its zenith here in the center, marked by a tiny stand of redwood trees. 

On the trees is a nest (empty).

>north
A Grassy Island, North End
The north end of the island descends into starlight. From the knee-high grasses here one can look out at the infinite stars. 

You can see a shadowy vessel and an alabaster monument here.

>north
You can't go that way.

>take vessel
The darkness darkens, and when it brightens again, you are somewhere else.

Emptiness
A vast darkness extends in all directions. Distantly, blurry motes of light seem to float on the horizon -- or it might be a trick of your eyes.

You can see a vessel (empty) here.

>south
You can't go that way.

>north
You can't go that way.

>east
You can't go that way.

(You might get a hint here.).

>west
You can't go that way.

>look motes
You can't see any such thing.

>look light
Tiny lights are still visible in the distance, but you'll be unable to summon more until this vessel is completed.

>look vessel
The vessel seems to be made from starglass, bright and translucent. Despite the darkness it seems to radiate a gentle light of its own.

>put feather
What do you want to put the feather in?

>vessel
You drop the feather into the vessel.

As the feather slips down past the edge of the starglass, it dissolves into a shadow that then inverts itself into light.

There is some hope in the vessel now.

>look vessel
The vessel seems to be made from starglass, bright and translucent. Despite the darkness it seems to radiate a gentle light of its own. Nebulous colors swirl within the vessel.

In the vessel is hope for the future.

>take vessel
The darkness darkens, and when it brightens again, you are somewhere else.

A Grassy Island, North End
The north end of the island descends into starlight. From the knee-high grasses here one can look out at the infinite stars. 

You can see a shadowy vessel and an alabaster monument here.

>inventory
You are carrying:
  a garnet tile

(You might get a hint here.).

>put tile
(in the garnet tile)
You can't put something inside itself.

>put tile
(in the garnet tile)
You can't put something inside itself.

>put tile in vessel
You reach toward the shadowy vessel, and the world moves.

The darkness darkens, and when it brightens again, you are somewhere else.

Emptiness
A vast darkness extends in all directions. Distantly, blurry motes of light seem to float on the horizon -- or it might be a trick of your eyes.

You can see a vessel (in which is hope for the future) here.

>look vessel
The vessel seems to be made from starglass, bright and translucent. Despite the darkness it seems to radiate a gentle light of its own. Nebulous colors swirl within the vessel.

In the vessel is hope for the future.

>inventory
You are carrying:
  a garnet tile

>take vessel
The darkness darkens, and when it brightens again, you are somewhere else.

A Grassy Island, North End
The north end of the island descends into starlight. From the knee-high grasses here one can look out at the infinite stars. 

You can see a shadowy vessel and an alabaster monument here.

>put tile
(in the garnet tile)
You can't put something inside itself.

* * *

>put tile in vessel
You reach toward the shadowy vessel, and the world moves.

The darkness darkens, and when it brightens again, you are somewhere else.

Emptiness
A vast darkness extends in all directions. Distantly, blurry motes of light seem to float on the horizon -- or it might be a trick of your eyes.

You can see a vessel (in which is hope for the future) here.

>put tile in vessel
You drop the tile into the vessel.

As the garnet tile descends into the vessel, it seems to slow, and slow, and slow -- and finally stop entirely. Light explodes outward from the inside of the gem, radiating outward until it illuminates the vessel in a near-blinding glow.

There is a piece of the infinite in the vessel now.

>look
Emptiness
A vast darkness extends in all directions. Distantly, blurry motes of light seem to float on the horizon -- or it might be a trick of your eyes.

You can see a vessel (in which are an a piece of the infinite and hope for the future) here.

>look
Emptiness
A vast darkness extends in all directions. Distantly, blurry motes of light seem to float on the horizon -- or it might be a trick of your eyes.

You can see a vessel (in which are an a piece of the infinite and hope for the future) here.

>look light
Tiny lights are still visible in the distance, but you'll be unable to summon more until this vessel is completed.

>take vessel
The darkness darkens, and when it brightens again, you are somewhere else.

A Grassy Island, North End
The north end of the island descends into starlight. From the knee-high grasses here one can look out at the infinite stars. 

You can see a shadowy vessel and an alabaster monument here.

(You might get a hint here.).

>take vessel
The darkness darkens, and when it brightens again, you are somewhere else.

Emptiness
A vast darkness extends in all directions. Distantly, blurry motes of light seem to float on the horizon -- or it might be a trick of your eyes.

You can see a vessel (in which are an a piece of the infinite and hope for the future) here.

>take vessel
The darkness darkens, and when it brightens again, you are somewhere else.

A Grassy Island, North End
The north end of the island descends into starlight. From the knee-high grasses here one can look out at the infinite stars. 

You can see a shadowy vessel and an alabaster monument here.

>north
You can't go that way.

>south
A Grassy Island, Center
The island rises to its zenith here in the center, marked by a tiny stand of redwood trees. 

On the trees is a nest (empty).

>look trees
A sudden narrow stand of redwoods erupts out of the ground at the center of the island. On one low slung branch of the nearest tree, you can see a nest made of twigs.

On the trees is a nest (empty).

>south
A Grassy Island, South End
A mirror for the north end of the island, the south end too rolls downward and gradually vanishes into darkness. The grasses here rise and fall in gentle hummocks.

>look
A Grassy Island, South End
A mirror for the north end of the island, the south end too rolls downward and gradually vanishes into darkness. The grasses here rise and fall in gentle hummocks.

>south
You can't go that way.

>look grasses
You can't see any such thing.

>look hummocks
You can't see any such thing.

>look hummock
As you part the fragrant grasses of one of the hummocks, you discover a tunnel leading down into a cave.

>look cave
You see nothing special about the cave.

>look tunnel
You can't see any such thing.

>south
You can't go that way.

>north
A Grassy Island, Center
The island rises to its zenith here in the center, marked by a tiny stand of redwood trees. 

On the trees is a nest (empty).

(You might get a hint here.).

>south
A Grassy Island, South End
A mirror for the north end of the island, the south end too rolls downward and gradually vanishes into darkness. The grasses here rise and fall in gentle hummocks. A tunnel leads downward into a subterranean cave.

You can see a cave here.

>go tunnel
You can't see any such thing.

>enter tunnel
You can't see any such thing.

>enter cave
A Grassy Island, Subterranean Cave
Light filters down from the grass-fringed opening of the tunnel. Soil and packed dirt give way to rock as the cave winds to the north.

>north
A Grassy Island, Subterranean Cave
The cave ends here in a rounded wall. A fox has made its nest here. 

You can see a growling fox here.

>look fox
You have cornered a female fox. She crouches, snarling, protecting the pups behind her.

>north
You can't go that way.

>take fox
Who do you mean, the fox pups or the growling fox?

>take growling fox
I don't suppose the growling fox would care for that.

>take fox pups
I don't suppose the fox pups would care for that.

>inventory
You are carrying nothing.

>look nest
You can't see any such thing.

>look pups
A group of five young pups huddles behind the fox mother. One fox is bright-eyed and sharp; another is rotund; another seems to be missing one eye; the fourth is unremarkable; and the last has a quiet intelligence.

As you peer closely at the pups, the mother fox snarls viciously again and hops at you, dislodging a pebble from the wall beside her.

(You might get a hint here.).

>look
A Grassy Island, Subterranean Cave
The cave ends here in a rounded wall. A fox has made its nest here. 

You can see a granite pebble, some fox pups and a growling fox here.

>take pebble
Taken.

>south
A Grassy Island, Subterranean Cave
Light filters down from the grass-fringed opening of the tunnel. Soil and packed dirt give way to rock as the cave winds to the north.

>south
You can't go that way.

>south
You can't go that way.

>north
A Grassy Island, Subterranean Cave
The cave ends here in a rounded wall. A fox has made its nest here. 

You can see some fox pups and a growling fox here.

>north
You can't go that way.

>south
A Grassy Island, Subterranean Cave
Light filters down from the grass-fringed opening of the tunnel. Soil and packed dirt give way to rock as the cave winds to the north.

>up
A Grassy Island, South End
A mirror for the north end of the island, the south end too rolls downward and gradually vanishes into darkness. The grasses here rise and fall in gentle hummocks. A tunnel leads downward into a subterranean cave.

You can see a cave here.

(You might get a hint here.).

>north
A Grassy Island, Center
The island rises to its zenith here in the center, marked by a tiny stand of redwood trees. 

On the trees is a nest (empty).

* * *

>north
A Grassy Island, North End
The north end of the island descends into starlight. From the knee-high grasses here one can look out at the infinite stars. 

You can see a shadowy vessel and an alabaster monument here.

>put pebble in vessel
You reach toward the shadowy vessel, and the world moves.

The darkness darkens, and when it brightens again, you are somewhere else.

Emptiness
A vast darkness extends in all directions. Distantly, blurry motes of light seem to float on the horizon -- or it might be a trick of your eyes.

You can see a vessel (in which are an a piece of the infinite and hope for the future) here.

>put pebble in vessel
You drop the pebble into the vessel.

The pebble bounces wildly off the sides of the vessel, unpredictable. With each bounce it gains a bit of speed, until finally it is flying, streaking.

A determined unconditional love bounces around the vessel now.

>look vessel
The vessel seems to be made from starglass, bright and translucent. Despite the darkness it seems to radiate a gentle light of its own. Nebulous colors swirl within the vessel.

In the vessel are unconditional love, an a piece of the infinite and hope for the future.

>north
You can't go that way.

>look vessel
The vessel seems to be made from starglass, bright and translucent. Despite the darkness it seems to radiate a gentle light of its own. Nebulous colors swirl within the vessel.

In the vessel are unconditional love, an a piece of the infinite and hope for the future.

>take vessel
The darkness darkens, and when it brightens again, you are somewhere else.

A Grassy Island, North End
The north end of the island descends into starlight. From the knee-high grasses here one can look out at the infinite stars. 

You can see a shadowy vessel and an alabaster monument here.

(You might get a hint here.).

>look stars
You can't see any such thing.

>south
A Grassy Island, Center
The island rises to its zenith here in the center, marked by a tiny stand of redwood trees. 

On the trees is a nest (empty).

>south
A Grassy Island, South End
A mirror for the north end of the island, the south end too rolls downward and gradually vanishes into darkness. The grasses here rise and fall in gentle hummocks. A tunnel leads downward into a subterranean cave.

You can see a cave here.

>south
You can't go that way.

>enter cave
A Grassy Island, Subterranean Cave
Light filters down from the grass-fringed opening of the tunnel. Soil and packed dirt give way to rock as the cave winds to the north.

>north
A Grassy Island, Subterranean Cave
The cave ends here in a rounded wall. A fox has made its nest here. 

You can see some fox pups and a growling fox here.

* * *

>north
You can't go that way.

>up
You can't go that way.

>south
A Grassy Island, Subterranean Cave
Light filters down from the grass-fringed opening of the tunnel. Soil and packed dirt give way to rock as the cave winds to the north.

>up
A Grassy Island, South End
A mirror for the north end of the island, the south end too rolls downward and gradually vanishes into darkness. The grasses here rise and fall in gentle hummocks. A tunnel leads downward into a subterranean cave.

You can see a cave here.

>north
A Grassy Island, Center
The island rises to its zenith here in the center, marked by a tiny stand of redwood trees. 

On the trees is a nest (empty).

* * *

>south
A Grassy Island, Center
The island rises to its zenith here in the center, marked by a tiny stand of redwood trees. 

On the trees is a nest (empty).

>east
A Grassy Island, East End
Sheltered from the star winds, this end of the island has a twilight tranquility. A gazebo looks out into the stars, surrounded by carefully manicured grass. 

You can see a pedestal (on which is a cloisonne pot (in which is a bonsai plant)) here.

(You might get a hint here.).

>look pot
The exquisitely painted pot contains a bonsai plant. Both are beautiful, but the plant seems to be straining at its confines.

In the cloisonne pot is a bonsai plant.

>look plant
This bonsai juniper has delicate leaves and an elegantly curving trunk. Its roots rise out of its small pot of soil, lifting it, straining against the lacquered sides.

>take plant
Taken.

>west
A Grassy Island, Center
The island rises to its zenith here in the center, marked by a tiny stand of redwood trees. 

On the trees is a nest (empty).

>north
A Grassy Island, North End
The north end of the island descends into starlight. From the knee-high grasses here one can look out at the infinite stars. 

You can see a shadowy vessel and an alabaster monument here.

>put plant in vessel
You reach toward the shadowy vessel, and the world moves.

The darkness darkens, and when it brightens again, you are somewhere else.

Emptiness
A vast darkness extends in all directions. Distantly, blurry motes of light seem to float on the horizon -- or it might be a trick of your eyes.

You can see a vessel (in which are unconditional love, an a piece of the infinite and hope for the future) here.

>put plant in vessel
You wouldn't want to put something living into the vessel.

>look vessel
The vessel seems to be made from starglass, bright and translucent. Despite the darkness it seems to radiate a gentle light of its own. Nebulous colors swirl within the vessel.

In the vessel are unconditional love, an a piece of the infinite and hope for the future.

>take vessel
The darkness darkens, and when it brightens again, you are somewhere else.

A Grassy Island, North End
The north end of the island descends into starlight. From the knee-high grasses here one can look out at the infinite stars. 

You can see a shadowy vessel and an alabaster monument here.

>south
A Grassy Island, Center
The island rises to its zenith here in the center, marked by a tiny stand of redwood trees. 

On the trees is a nest (empty).

>west
A Grassy Island, West End
The ground rises here into an angled precipice of stacked stone that looks out into the sky. Perched on the edge of the precipice is a brass telescope, trained on a distant blue planet.

You can see a brass telescope (closed) here.

>look telescope
A long tube of brass punctuated by focusing rings is pointed at a tiny blue dot in the distant sky. Within the telescope is a series of lenses.

>use telescope
That's not a verb I recognise.

>take telescope
It is bolted to the precipice, probably for stability.

>look in telescope
You train the telescope on the blue planet. Far, far below, you see a family eating dinner.

>look in telescope
You train the telescope on the blue planet. Far, far below, you see a boy playing fetch with a dog.

>look in telescope
You train the telescope on the blue planet. Far, far below, you see a man holding up a convenience store with a gun.

>look in telescope
You train the telescope on the blue planet. Far, far below, you see a couple shouting at each other.

>look in telescope
You train the telescope on the blue planet. Far, far below, you see a long table of world leaders discussing a conflict.

>look in telescope
You train the telescope on the blue planet. Far, far below, you see a group of women gathering rice.

>look in telescope
You train the telescope on the blue planet. Far, far below, you see a jet fighter blasting across the sky.

>look in telescope
You train the telescope on the blue planet. Far, far below, you see a girl constructing a robot.

>look in telescope
You train the telescope on the blue planet. Far, far below, you see a couple shouting at each other.

>look in telescope
You train the telescope on the blue planet. Far, far below, you see a boy playing fetch with a dog.

>look in telescope
You train the telescope on the blue planet. Far, far below, you see a long table of world leaders discussing a conflict.

>look in telescope
You train the telescope on the blue planet. Far, far below, you see a man holding up a convenience store with a gun.

>look in telescope
You train the telescope on the blue planet. Far, far below, you see a girl constructing a robot.

>take lens
You can't see any such thing.

>take lenses
You can't see any such thing.

>look
A Grassy Island, West End
The ground rises here into an angled precipice of stacked stone that looks out into the sky. Perched on the edge of the precipice is a brass telescope, trained on a distant blue planet.

You can see a brass telescope (closed) here.

>inventory
You are carrying:
  a bonsai plant

>west
You can't go that way.

>east
A Grassy Island, Center
The island rises to its zenith here in the center, marked by a tiny stand of redwood trees. 

On the trees is a nest (empty).

>west
A Grassy Island, West End
The ground rises here into an angled precipice of stacked stone that looks out into the sky. Perched on the edge of the precipice is a brass telescope, trained on a distant blue planet.

You can see a brass telescope (closed) here.

>open telescope
You carefully unscrew the brass cuff at the far end of the telescope.

(You might get a hint here.).

>look telescope
A long tube of brass punctuated by focusing rings is pointed at a tiny blue dot in the distant sky. Within the telescope is a series of lenses.

In the brass telescope is a glass lens.

>take lens
Taken.

>east
A Grassy Island, Center
The island rises to its zenith here in the center, marked by a tiny stand of redwood trees. 

On the trees is a nest (empty).

>north
A Grassy Island, North End
The north end of the island descends into starlight. From the knee-high grasses here one can look out at the infinite stars. 

You can see a shadowy vessel and an alabaster monument here.

>put lens in vessel
You reach toward the shadowy vessel, and the world moves.

The darkness darkens, and when it brightens again, you are somewhere else.

Emptiness
A vast darkness extends in all directions. Distantly, blurry motes of light seem to float on the horizon -- or it might be a trick of your eyes.

You can see a vessel (in which are unconditional love, an a piece of the infinite and hope for the future) here.

>put lens in vessel
You drop the glass lens into the vessel.

It falls, spinning, into the glowing depths. It spins faster and faster until it becomes a sphere of golden light.

Faith in humanity fills the vessel now.

>look vessel
The vessel seems to be made from starglass, bright and translucent. Despite the darkness it seems to radiate a gentle light of its own. Nebulous colors swirl within the vessel.

In the vessel are faith in humanity, unconditional love, an a piece of the infinite and hope for the future.

>take vessel
The darkness darkens, and when it brightens again, you are somewhere else.

A Grassy Island, North End
The north end of the island descends into starlight. From the knee-high grasses here one can look out at the infinite stars. 

You can see a shadowy vessel and an alabaster monument here.

(You might get a hint here.).

>south
A Grassy Island, Center
The island rises to its zenith here in the center, marked by a tiny stand of redwood trees. 

On the trees is a nest (empty).

>west
A Grassy Island, West End
The ground rises here into an angled precipice of stacked stone that looks out into the sky. Perched on the edge of the precipice is a brass telescope, trained on a distant blue planet.

You can see a brass telescope (empty) here.

>east
A Grassy Island, Center
The island rises to its zenith here in the center, marked by a tiny stand of redwood trees. 

On the trees is a nest (empty).

>east
A Grassy Island, East End
Sheltered from the star winds, this end of the island has a twilight tranquility. A gazebo looks out into the stars, surrounded by carefully manicured grass. 

You can see a pedestal (on which is a cloisonne pot (empty)) here.

>take pot
Taken.

>west
A Grassy Island, Center
The island rises to its zenith here in the center, marked by a tiny stand of redwood trees. 

On the trees is a nest (empty).

* * *

>north
A Grassy Island, North End
The north end of the island descends into starlight. From the knee-high grasses here one can look out at the infinite stars. 

You can see a shadowy vessel and an alabaster monument here.

>put pot in vessel
You reach toward the shadowy vessel, and the world moves.

The darkness darkens, and when it brightens again, you are somewhere else.

Emptiness
A vast darkness extends in all directions. Distantly, blurry motes of light seem to float on the horizon -- or it might be a trick of your eyes.

You can see a vessel (in which are faith in humanity, unconditional love, an a piece of the infinite and hope for the future) here.

>put pot in vessel
The pot won't fit into the vessel. You'd have to drop and break it to make any of it fit.

(You might get a hint here.).

>drop pot
You tip your hand over and drop the cloisonne pot from a respectable height. It smashes into the ground quite satisfactorily, leaving only a handful of shards.

>get shard
You can't see any such thing.

>get shards
Taken.

>put shards in vessel
You drop the cloisonne shards into the vessel.

As the shards fall into the vessel, they whirl apart from each other in a wild release, then flash into pure light.

Control has been relinquished into the vessel now.

* * *

The colors inside the vessel begin to swirl around each other. They move faster and faster until they begin to blur together. When finally they merge, there is a great flash.
(There would be a picture of the sonogram here.)

    *** The End ***

Would you like to RESTART, RESTORE a saved game, QUIT or UNDO the last command?

* * *

>look light
Tiny motes of light float just at the edges of your vision. It's hard to tell if they're there at all.

>look light
Tiny motes of light float just at the edges of your vision. It's hard to tell if they're there at all.

>look light'
You can't see any such thing.

>look light'
You can't see any such thing.

>look light
Tiny motes of light float just at the edges of your vision. It's hard to tell if they're there at all.

>take light
The lights are small and elusive. They might respond to beckoning.

>beckon light
You gesture invitingly toward the light. It pauses in midair, then, very distinctly, it draws closer.

* * *

>touch light
You stretch out your hand and brush the light with your fingertips.

The light shimmers close, weaves one little loop around you, then gathers at your feet. It pools upward, forming a cup, and finally a vessel.

>take vessel
The darkness darkens, and when it brightens again, you are somewhere else.

A Grassy Island, North End
The north end of the island descends into starlight. From the knee-high grasses here one can look out at the infinite stars. 

You can see a shadowy vessel and an alabaster monument here.

* * *

>look through
What do you want to look through?

* * *

>taste stars
You open your mouth and imagine you can taste the ancient stars.

>look stars
Whirling galaxies and winking stars extend as far as you can see.

* * *

>use light
You must supply a noun.

>use
What do you want to use?

>beckon light
You gesture invitingly toward the light. It pauses in midair, then, very distinctly, it draws closer.

>beckon light
You beckon the light closer again. Again it grows still, seeming to watch you. In its stillness it seems suddenly alive.

After a long moment, the light again swings closer to you.

The gentle light is quite close. You could almost reach out and touch it, but not quite.

>beckon light
The light seems less hesitant now, and it's grown larger. Now when you beckon it seems to have been waiting for your gesture, and it immediately floats closer to your hand, near enough to touch.

>beckon light
You beckon again, but the light is already as close as it will dare to come. It loops around you again, close enough to touch.

>touch ilght
You can't see any such thing.

>touch light
You stretch out your hand and brush the light with your fingertips.

The light shimmers close, weaves one little loop around you, then gathers at your feet. It pools upward, forming a cup, and finally a vessel.

>use vessel
You must supply a noun.

* * *

>wait
Time passes.

>beckon light
You gesture invitingly toward the light. It pauses in midair, then, very distinctly, it draws closer.

* * *

>beckon light
You beckon the light closer again. Again it grows still, seeming to watch you. In its stillness it seems suddenly alive.

After a long moment, the light again swings closer to you.

The gentle light is quite close. You could almost reach out and touch it, but not quite.

>beckon light
The light seems less hesitant now, and it's grown larger. Now when you beckon it seems to have been waiting for your gesture, and it immediately floats closer to your hand, near enough to touch.

The gentle light swings in little figure eights through the air, passing close enough to touch.

>touch light
You stretch out your hand and brush the light with your fingertips.

The light shimmers close, weaves one little loop around you, then gathers at your feet. It pools upward, forming a cup, and finally a vessel.

* * *

>south
A Grassy Island, South End
A mirror for the north end of the island, the south end too rolls downward and gradually vanishes into darkness. The grasses here rise and fall in gentle hummocks. 

A path leads north back to the center of the island from here.

>search hummock
You find nothing of interest.

>look
A Grassy Island, South End
A mirror for the north end of the island, the south end too rolls downward and gradually vanishes into darkness. The grasses here rise and fall in gentle hummocks. 

A path leads north back to the center of the island from here.

>look at hummock
As you part the fragrant grasses of one of the hummocks, you discover a tunnel leading down into a cave.

>look
A Grassy Island, South End
A mirror for the north end of the island, the south end too rolls downward and gradually vanishes into darkness. The grasses here rise and fall in gentle hummocks. A tunnel leads downward into a subterranean cave.

You can see a cave here.

* * *

>wait
Time passes.

>wait
Time passes.

>wait
Time passes.

A gentle light glimmers in the distance. You might beckon it.